//MAP CONVERTED BY dmm2tgm.py THIS HEADER COMMENT PREVENTS RECONVERSION, DO NOT REMOVE
"a" = (
/turf/unsimulated/mineral,
/area/space)
"c" = (
/mob/living/simple_animal/hostile/vagrant,
/turf/exterior/sand,
/area/space)
"e" = (
/turf/exterior/water,
/area/space)
"j" = (
/turf/simulated/wall/iron,
/area/space)
"l" = (
/obj/item/gun/projectile/bolt_action/sniper,
/obj/structure/table/woodentable,
/turf/simulated/floor/wood,
/area/space)
"n" = (
/turf/exterior/concrete,
/area/space)
"p" = (
/obj/structure/cable{
	dir = 1
	},
/obj/machinery/power/apc/hyper{
	dir = 1;
	pixel_y = 18
	},
/turf/exterior/sand,
/area/space)
"w" = (
/turf/simulated/floor/wood,
/area/space)
"y" = (
/mob/living/carbon/human/dummy,
/turf/simulated/floor/wood,
/area/space)
"z" = (
/obj/structure/door/maple,
/turf/simulated/floor/wood,
/area/space)
"E" = (
/obj/machinery/power/debug_items/infinite_generator,
/obj/structure/cable,
/turf/exterior/sand,
/area/space)
"G" = (
/obj/abstract/landmark/latejoin/cryo,
/turf/simulated/floor/wood,
/area/space)
"L" = (
/turf/exterior/sand,
/area/space)
"M" = (
/obj/machinery/gravity_generator,
/turf/exterior/sand,
/area/space)
"U" = (
/mob/living/simple_animal/hostile/antlion,
/turf/exterior/sand,
/area/space)
"X" = (
/obj/item/gun/projectile/automatic/smg,
/obj/structure/table/woodentable,
/turf/simulated/floor/wood,
/area/space)
"Z" = (
/obj/item/gun/projectile/automatic/assault_rifle,
/obj/structure/table/woodentable,
/turf/simulated/floor/wood,
/area/space)

(1,1,1) = {"
a
a
a
a
a
a
a
a
a
a
a
a
a
a
a
a
a
a
a
a
a
a
a
a
a
a
a
a
a
a
a
a
a
a
a
a
a
a
a
a
a
a
a
a
a
a
a
a
a
a
"}
(2,1,1) = {"
a
M
L
L
L
a
L
L
L
L
L
L
L
L
L
L
L
L
L
L
L
L
L
L
L
L
L
L
L
L
L
L
L
L
L
L
L
L
L
L
L
L
L
L
L
L
L
L
L
a
"}
(3,1,1) = {"
a
L
L
L
L
a
L
L
L
L
L
L
L
L
L
L
L
L
L
L
L
L
L
L
L
L
L
L
L
L
L
L
L
L
L
L
L
L
L
L
L
L
L
L
L
L
L
L
L
a
"}
(4,1,1) = {"
a
L
L
L
L
a
L
L
L
L
L
L
L
L
L
L
L
L
L
L
L
L
L
L
L
L
L
L
L
L
L
L
L
L
L
L
L
L
L
L
L
L
L
L
L
L
L
L
L
a
"}
(5,1,1) = {"
a
p
E
L
L
a
L
L
L
L
L
L
L
L
L
L
L
L
L
L
L
L
L
L
L
L
L
L
L
L
L
L
L
L
L
L
L
L
L
L
L
L
L
L
L
L
L
L
L
a
"}
(6,1,1) = {"
a
L
L
L
L
a
L
L
L
L
L
L
L
L
L
L
L
L
L
L
L
L
L
L
L
L
L
L
L
L
L
L
L
L
L
L
L
L
L
L
L
L
L
L
L
L
L
L
L
a
"}
(7,1,1) = {"
a
a
a
a
a
a
L
L
L
L
L
L
L
L
L
L
L
L
L
L
L
L
L
L
L
L
L
L
L
L
L
L
L
L
L
L
L
L
L
L
L
L
L
L
L
L
L
L
L
a
"}
(8,1,1) = {"
a
L
L
L
L
L
L
L
L
L
L
L
L
L
L
L
L
L
L
L
L
L
L
L
L
L
L
L
L
L
L
L
L
L
L
L
L
L
L
L
L
L
L
L
L
L
L
L
L
a
"}
(9,1,1) = {"
a
L
L
L
L
L
L
L
L
L
L
L
L
L
L
L
L
L
L
L
L
L
L
L
L
L
L
L
L
L
L
L
L
L
L
L
L
L
L
L
L
L
L
L
L
L
L
L
L
a
"}
(10,1,1) = {"
a
L
L
L
L
L
L
L
L
L
L
L
L
L
L
L
L
L
L
L
L
L
L
L
L
L
L
L
L
L
L
L
L
L
L
L
L
L
L
L
L
L
L
L
L
L
L
L
L
a
"}
(11,1,1) = {"
a
L
L
L
L
L
L
L
L
L
L
L
L
L
L
L
L
L
L
L
L
L
L
L
L
L
L
L
L
L
L
L
L
L
L
L
L
L
L
L
L
L
L
L
L
L
L
L
L
a
"}
(12,1,1) = {"
a
L
L
L
L
L
L
L
L
L
L
L
L
L
L
L
L
L
L
L
L
L
L
L
L
L
L
L
L
L
L
L
L
L
L
L
L
L
L
L
L
L
L
L
L
L
L
L
L
a
"}
(13,1,1) = {"
a
L
L
L
L
L
n
n
n
n
n
n
n
n
n
n
n
n
n
n
n
n
n
n
n
n
n
n
n
n
n
n
n
n
n
n
n
n
n
n
n
n
n
n
n
n
L
L
L
a
"}
(14,1,1) = {"
a
L
L
L
L
L
n
n
n
n
n
n
n
n
n
n
n
n
n
n
n
n
n
n
n
n
n
n
n
n
n
n
n
n
n
n
n
n
n
n
n
n
n
n
n
n
L
L
L
a
"}
(15,1,1) = {"
a
L
L
L
L
L
n
n
n
n
n
n
n
n
n
n
n
n
n
n
n
n
n
n
n
n
n
n
n
n
n
n
n
n
n
n
n
n
n
n
n
n
n
n
n
n
L
L
L
a
"}
(16,1,1) = {"
a
L
L
L
L
L
n
n
n
L
L
L
L
L
L
L
L
L
L
L
L
L
L
L
L
L
L
L
L
L
L
L
L
L
L
L
L
L
L
L
L
L
L
n
n
n
L
L
L
a
"}
(17,1,1) = {"
a
L
L
L
L
e
n
n
n
U
L
L
L
L
L
L
L
L
L
L
L
L
L
L
L
L
L
L
L
L
L
L
L
L
L
L
L
L
L
L
L
L
L
n
n
n
L
L
L
a
"}
(18,1,1) = {"
a
L
L
L
L
e
n
n
n
L
U
L
L
L
L
L
L
L
L
L
L
L
L
L
L
L
L
L
L
L
L
L
L
L
L
L
L
L
L
L
L
L
L
n
n
n
L
L
L
a
"}
(19,1,1) = {"
a
L
L
L
L
e
n
n
n
L
L
L
L
L
L
L
L
L
L
L
L
L
L
L
L
L
L
L
L
L
L
L
L
L
L
L
L
L
L
L
L
L
L
n
n
n
L
L
L
a
"}
(20,1,1) = {"
a
L
L
L
e
e
n
n
n
L
L
L
L
L
L
L
L
L
L
L
L
L
L
L
L
L
L
L
L
L
L
L
L
L
L
L
L
L
L
L
L
L
L
n
n
n
L
L
L
a
"}
(21,1,1) = {"
a
L
L
L
e
e
n
n
n
U
L
L
L
L
L
L
L
L
L
L
L
L
L
L
L
L
L
L
L
L
L
L
L
L
L
L
L
L
L
L
L
L
L
n
n
n
L
L
L
a
"}
(22,1,1) = {"
a
L
L
L
e
e
n
n
n
L
L
L
L
L
L
L
L
L
L
L
L
L
L
L
L
L
L
L
L
L
L
L
L
L
L
L
L
L
L
L
L
L
L
n
n
n
L
L
L
a
"}
(23,1,1) = {"
a
L
L
L
e
e
n
n
n
L
L
L
c
L
L
L
L
L
L
L
L
L
L
L
L
L
L
L
L
L
L
L
L
L
L
L
L
L
L
L
L
L
L
n
n
n
L
L
L
a
"}
(24,1,1) = {"
a
L
L
L
e
e
n
n
n
L
L
L
L
L
L
L
L
L
L
L
L
L
L
L
L
L
L
L
L
L
L
L
L
L
L
L
L
L
L
L
L
L
L
n
n
n
L
L
L
a
"}
(25,1,1) = {"
a
L
L
L
e
e
n
n
n
L
L
L
L
L
L
L
L
L
L
L
L
L
L
L
L
L
L
L
L
L
L
L
L
L
L
L
j
j
j
j
j
j
j
n
n
n
L
L
L
a
"}
(26,1,1) = {"
a
L
L
L
e
e
n
n
n
L
L
L
L
L
L
L
L
L
L
L
L
L
L
L
L
L
L
L
L
L
L
L
L
L
L
L
j
Z
w
w
w
w
j
n
n
n
L
L
L
a
"}
(27,1,1) = {"
a
L
L
L
e
e
n
n
n
L
L
L
L
L
L
L
L
L
L
L
L
L
L
L
L
L
L
L
L
L
L
L
L
L
L
L
j
l
w
w
w
G
j
n
n
n
L
L
L
a
"}
(28,1,1) = {"
a
L
L
L
e
e
n
n
n
L
L
L
L
L
L
L
L
L
L
L
L
L
L
L
L
L
L
L
L
L
L
L
L
L
L
L
j
X
w
w
w
w
j
n
n
n
L
L
L
a
"}
(29,1,1) = {"
a
L
L
L
e
e
n
n
n
L
L
L
L
L
L
L
L
L
L
L
L
L
L
L
L
L
L
L
L
L
L
L
L
L
L
L
j
w
w
w
w
w
z
n
n
n
L
L
L
a
"}
(30,1,1) = {"
a
L
L
L
e
e
n
n
n
L
L
L
L
L
L
L
L
L
L
L
L
L
L
L
L
L
L
L
L
L
L
L
L
L
L
L
j
y
w
w
w
w
j
n
n
n
L
L
L
a
"}
(31,1,1) = {"
a
L
L
L
e
e
n
n
n
L
L
L
L
L
L
L
L
L
L
L
L
L
L
L
L
L
L
L
L
L
L
L
L
L
L
L
j
w
w
w
w
G
j
n
n
n
L
L
L
a
"}
(32,1,1) = {"
a
L
L
L
e
e
n
n
n
L
L
L
L
L
L
L
L
L
L
L
L
L
L
L
L
L
L
L
L
L
L
L
L
L
L
L
j
w
w
w
w
w
j
n
n
n
L
L
L
a
"}
(33,1,1) = {"
a
L
L
L
e
e
n
n
n
L
L
L
L
L
L
L
L
L
L
L
L
L
L
L
L
L
L
L
L
L
L
L
L
L
L
L
j
j
j
j
j
j
j
n
n
n
L
L
L
a
"}
(34,1,1) = {"
a
L
L
L
e
e
n
n
n
L
L
L
L
L
L
L
L
L
L
L
L
L
L
L
L
L
L
L
L
L
L
L
L
L
L
L
L
L
L
L
L
L
L
n
n
n
L
L
L
a
"}
(35,1,1) = {"
a
L
L
L
e
e
n
n
n
L
L
L
L
L
L
L
L
L
L
L
L
L
L
L
L
L
L
L
L
L
L
L
L
L
L
L
L
L
L
L
L
L
L
n
n
n
L
L
L
a
"}
(36,1,1) = {"
a
L
L
L
e
e
n
n
n
L
L
L
L
L
L
L
L
L
L
L
L
L
L
L
L
L
L
L
L
L
L
L
L
L
L
L
L
L
L
L
L
L
L
n
n
n
L
L
L
a
"}
(37,1,1) = {"
a
L
L
L
L
e
n
n
n
L
L
L
L
L
L
L
L
L
L
L
L
L
L
L
L
L
L
L
L
L
L
L
L
L
L
L
L
L
L
L
L
L
L
n
n
n
L
L
L
a
"}
(38,1,1) = {"
a
L
L
L
L
e
n
n
n
L
L
L
L
L
L
L
L
L
L
L
L
L
L
L
L
L
L
L
L
L
L
L
L
L
L
L
L
L
L
L
L
L
L
n
n
n
L
L
L
a
"}
(39,1,1) = {"
a
L
L
L
L
e
n
n
n
L
L
L
L
L
L
L
L
L
L
L
L
L
L
L
L
L
L
L
L
L
L
L
L
L
L
L
L
L
L
L
L
L
L
n
n
n
L
L
L
a
"}
(40,1,1) = {"
a
L
L
L
L
e
n
n
n
L
L
L
L
L
L
L
L
L
L
L
L
L
L
L
L
L
L
L
L
L
L
L
L
L
L
L
L
L
L
L
L
L
L
n
n
n
L
L
L
a
"}
(41,1,1) = {"
a
L
L
L
L
e
n
n
n
L
L
L
L
L
L
L
L
L
L
L
L
L
L
L
L
L
L
L
L
L
L
L
L
L
L
L
L
L
L
L
L
L
L
n
n
n
L
L
L
a
"}
(42,1,1) = {"
a
L
L
L
L
e
n
n
n
L
L
L
L
L
L
L
L
L
L
L
L
L
L
L
L
L
L
L
L
L
L
L
L
L
L
L
L
L
L
L
L
L
L
n
n
n
L
L
L
a
"}
(43,1,1) = {"
a
L
L
L
L
e
n
n
n
L
L
L
L
L
L
L
L
L
L
L
L
L
L
L
L
L
L
L
L
L
L
L
L
L
L
L
L
L
L
L
L
L
L
n
n
n
L
L
L
a
"}
(44,1,1) = {"
a
L
L
L
L
L
n
n
n
n
n
n
n
n
n
n
n
n
n
n
n
n
n
n
n
n
n
n
n
n
n
n
n
n
n
n
n
n
n
n
n
n
n
n
n
n
L
L
L
a
"}
(45,1,1) = {"
a
L
L
L
L
L
n
n
n
n
n
n
n
n
n
n
n
n
n
n
n
n
n
n
n
n
n
n
n
n
n
n
n
n
n
n
n
n
n
n
n
n
n
n
n
n
L
L
L
a
"}
(46,1,1) = {"
a
L
L
L
L
L
n
n
n
n
n
n
n
n
n
n
n
n
n
n
n
n
n
n
n
n
n
n
n
n
n
n
n
n
n
n
n
n
n
n
n
n
n
n
n
n
L
L
L
a
"}
(47,1,1) = {"
a
L
L
L
L
L
L
L
L
L
L
L
L
L
L
L
L
L
L
L
L
L
L
L
L
L
L
L
L
L
L
L
L
L
L
L
L
L
L
L
L
L
L
L
L
L
L
L
L
a
"}
(48,1,1) = {"
a
L
L
L
L
L
L
L
L
L
L
L
L
L
L
L
L
L
L
L
L
L
L
L
L
L
L
L
L
L
L
L
L
L
L
L
L
L
L
L
L
L
L
L
L
L
L
L
L
a
"}
(49,1,1) = {"
a
L
L
L
L
L
L
L
L
L
L
L
L
L
L
L
L
L
L
L
L
L
L
L
L
L
L
L
L
L
L
L
L
L
L
L
L
L
L
L
L
L
L
L
L
L
L
L
L
a
"}
(50,1,1) = {"
a
a
a
a
a
a
a
a
a
a
a
a
a
a
a
a
a
a
a
a
a
a
a
a
a
a
a
a
a
a
a
a
a
a
a
a
a
a
a
a
a
a
a
a
a
a
a
a
a
a
"}
